{
    "name": "river",
    "data": [
        [1  , 1  , 1  , 1  , 1  , 1  , 1  , 1  , 1  , 1  , 1  , 1  ],
        [1  , 10, 2  , 2  , 2  , 2  , 2  , 2  , 2  , 2  , 11, 1  ],
        [1  , 5  , 0  , 0  , 0  , 0  , 0  , 0  , 0  , 0  , 4  , 1  ],
        [1  , 5  , 0  , 14, 0  , 0  , 0  , 0  , 0  , 0  , 4  , 1  ],
        [1  , 5  , 0  , 0  , 0  , 0  , 0  , 0  , 0  , 6  , 13, 1  ],
        [1  , 5  , 0  , 0  , 0  , 0  , 0  , 0  , 0  , 4  , 1  , 1  ],
        [1  , 5  , 0  , 0  , 0  , 0  , 0  , 0  , 6  , 13, 1  , 1  ],
        [1  , 12, 3  , 3  , 3  , 3  , 3  , 3  , 13, 1  , 1  , 1  ],
        [1  , 1  , 1  , 1  , 1  , 1  , 1  , 1  , 1  , 1  , 1  , 1  ]
    ]
}