{
    "name": "river",
    "data": [
        [1  , 18, 10, 2  , 2  , 2  , 2  , 2  , 11, 1  , 1  , 17],
        [10, 2  , 9  , 0  , 0  , 0  , 0  , 0  , 8  , 2  , 11, 16],
        [5  , 0  , 0  , 0  , 0  , 0  , 0  , 0  , 0  , 0  , 4  , 1  ],
        [5  , 0  , 0  , 0  , 0  , 0  , 0  , 0  , 0  , 0  , 4  , 1  ],
        [5  , 0  , 0  , 0  , 0  , 0  , 0  , 0  , 0  , 6  , 13, 1  ],
        [12, 7  , 0  , 0  , 0  , 0  , 0  , 0  , 0  , 4  , 19 , 1 ],
        [1  , 5  , 0  , 0  , 0  , 0  , 0  , 0  , 6  , 13, 20 , 1 ],
        [16, 12, 3  , 3  , 3  , 3  , 3  , 3  , 13, 1  , 17, 1  ],
        [1  , 1  , 1  , 1  , 18, 1  , 1  , 1  , 16, 1  , 1  , 1  ]
    ]
}